NO ./textures/no.xpm
SO ./textures/so.xpm
WE ./textures/we.xpm
EA ./textures/ea.xpm

F 255,255,255
C 200,100,2

     11111111111
1111110000000001
1000000000111111
10000000001
10000000001
10000000001
10000000001
1000000000111111111111
100000000000W000000001
1111111111111111111111